8 1 1 1 1 1 1 1 1 1 1 1 13 14 1 1 1 1 1 5
4 16 0 0 0 0 10 10 0 0 0 0 0 0 0 0 0 0 0 17
4 0 0 0 0 0 0 0 0 0 0 0 0 0 0 0 0 0 0 17
4 0 0 0 0 0 0 0 0 0 0 0 0 0 00 21 0 0 0 17
4 0 0 0 0 0 0 0 20 0 20 0 20 0 20 0 0 0 0 17
4 0 0 0 0 0 0 0 0 0 0 0 0 0 0 22 0 0 0 17
4 12 0 0 0 0 0 0 0 0 0 0 0 0 0 0 0 0 0 17
8 1 1 1 1 0 1 5 0 0 0 0 0 0 0 0 0 0 0 2
4 0 0 0 0 0 10 2 10 0 0 0 0 0 0 0 0 0 0 2
4 0 0 0 0 0 0 2 12 0 0 0 0 0 0 0 0 0 0 2
4 0 0 0 0 0 0 2 0 0 0 0 0 0 0 0 0 0 0 2
4 0 0 0 0 0 0 2 11 0 0 0 0 0 0 0 0 0 0 2
4 0 0 10 0 0 0 2 11 0 0 0 0 0 0 0 0 0 0 15
4 19 0 0 0 0 11 2 0 0 0 0 0 0 0 0 0 0 0 2
4 18 0 0 0 0 11 2 12 0 0 10 12 0 0 0 0 0 11 2
7 3 3 3 3 3 3 6 3 3 3 3 3 3 3 3 3 3 3 6